Abert's Towhee - Melozone aberti
Acadian Flycatcher - Empidonax virescens
Acorn Woodpecker - Melanerpes formicivorus
Alder Flycatcher - Empidonax alnorum
Aleutian Tern - Onychoprion aleuticus
Allen's Hummingbird - Selasphorus sasin
Altamira Oriole - Icterus gularis
American Avocet - Recurvirostra americana
American Bittern - Botaurus lentiginosus
American Black Duck - Anas rubripes
American Coot - Fulica americana
American Crow - Corvus brachyrhynchos
American Dipper - Cinclus mexicanus
American Golden-Plover - Pluvialis dominica
American Goldfinch - Spinus tristis
American Kestrel - Falco sparverius
American Oystercatcher - Haematopus palliatus
American Pipit - Anthus rubescens
American Redstart - Setophaga ruticilla
American Robin - Turdus migratorius
American Tree Sparrow - Spizelloides arborea
American White Pelican - Pelecanus erythrorhynchos
American Wigeon - Mareca americana
American Woodcock - Scolopax minor
Ancient Murrelet - Synthliboramphus antiquus
Anhinga - Anhinga anhinga
Anna's Hummingbird - Calypte anna
Antillean Nighthawk - Chordeiles gundlachii
Antillean Palm Swift - Tachornis phoenicobia
Aplomado Falcon - Falco femoralis
Arctic Loon - Gavia arctica
Arctic Tern - Sterna paradisaea
Arctic Warbler - Phylloscopus borealis
Arizona Woodpecker - Leuconotopicus arizonae
Ash-throated Flycatcher - Myiarchus cinerascens
Ashy Storm-Petrel - Oceanodroma homochroa
Asian Brown Flycatcher - Muscicapa dauurica
Atlantic Puffin - Fratercula arctica
Audubon's Oriole - Icterus graduacauda
Audubon's Shearwater - Puffinus lherminieri
Aztec Thrush - Ridgwayia pinicola
Azure Gallinule - Porphyrio flavirostris
Bachman's Sparrow - Peucaea aestivalis
Bachman's Warbler - Vermivora bachmanii
Bahama Mockingbird - Mimus gundlachii
Bahama Swallow - Tachycineta cyaneoviridis
Bahama Woodstar - Calliphlox evelynae
Baikal Teal - Sibirionetta formosa
Baird's Sandpiper - Calidris bairdii
Baird's Sparrow - Ammodramus bairdii
Bald Eagle - Haliaeetus leucocephalus
Baltimore Oriole - Icterus galbula
Bananaquit - Coereba flaveola
Band-rumped Storm-Petrel - Oceanodroma castro
Band-tailed Gull - Larus belcheri
Band-tailed Pigeon - Patagioenas fasciata
Bank Swallow - Riparia riparia
Bar-tailed Godwit - Limosa lapponica
Barn Owl - Tyto alba
Barn Swallow - Hirundo rustica
Barnacle Goose - Branta leucopsis
Barred Owl - Strix varia
Barrow's Goldeneye - Bucephala islandica
Bay-breasted Warbler - Setophaga castanea
Bean Goose - Anser fabalis
Bell's Vireo - Vireo bellii
Belted Kingfisher - Megaceryle alcyon
Bendire's Thrasher - Toxostoma bendirei
Berylline Hummingbird - Amazilia beryllina
Bewick's Wren - Thryomanes bewickii
Bicknell's Thrush - Catharus bicknelli
Black Catbird - Melanoptila glabrirostris
Black Guillemot - Cepphus grylle
Black Noddy - Anous minutus
Black Oystercatcher - Haematopus bachmani
Black Phoebe - Sayornis nigricans
Black Rail - Laterallus jamaicensis
Black Rosy-Finch - Leucosticte atrata
Black Scoter - Melanitta americana
Black Skimmer - Rynchops niger
Black Storm-Petrel - Oceanodroma melania
Black Swift - Cypseloides niger
Black Tern - Chlidonias niger
Black Turnstone - Arenaria melanocephala
Black Vulture - Coragyps atratus
Black-and-white Warbler - Mniotilta varia
Black-backed Wagtail - Motacilla lugens
Black-backed Woodpecker - Picoides arcticus
Black-bellied Plover - Pluvialis squatarola
Black-bellied Whistling-Duck - Dendrocygna autumnalis
Black-billed Cuckoo - Coccyzus erythropthalmus
Black-billed Magpie - Pica hudsonia
Black-browed Albatross - Thalassarche melanophris
Black-capped Chickadee - Poecile atricapillus
Black-capped Gnatcatcher - Polioptila nigriceps
Black-capped Petrel - Pterodroma hasitata
Black-capped Vireo - Vireo atricapilla
Black-chinned Hummingbird - Archilochus alexandri
Black-chinned Sparrow - Spizella atrogularis
Black-crowned Night-Heron - Nycticorax nycticorax
Black-faced Grassquit - Tiaris bicolor
Black-footed Albatross - Phoebastria nigripes
Black-headed Grosbeak - Pheucticus melanocephalus
Black-headed Gull - Chroicocephalus ridibundus
Black-legged Kittiwake - Rissa tridactyla
Black-necked Stilt - Himantopus mexicanus
Black-tailed Gnatcatcher - Polioptila melanura
Black-tailed Godwit - Limosa limosa
Black-tailed Gull - Larus crassirostris
Black-throated Blue Warbler - Setophaga caerulescens
Black-throated Gray Warbler - Setophaga nigrescens
Black-throated Green Warbler - Setophaga virens
Black-throated Sparrow - Amphispiza bilineata
Black-vented Oriole - Icterus wagleri
Black-vented Shearwater - Puffinus opisthomelas
Black-whiskered Vireo - Vireo altiloquus
Black-winged Stilt - Himantopus himantopus
Blackburnian Warbler - Setophaga fusca
Blackpoll Warbler - Setophaga striata
Blue Bunting - Cyanocompsa parellina
Blue Grosbeak - Passerina caerulea
Blue Grouse - Dendragapus obscurus
Blue Jay - Cyanocitta cristata
Blue Mockingbird - Melanotis caerulescens
Blue-footed Booby - Sula nebouxii
Blue-gray Gnatcatcher - Polioptila caerulea
Blue-headed Vireo - Vireo solitarius
Blue-throated Hummingbird - Lampornis clemenciae
Blue-winged Teal - Anas discors
Blue-winged Warbler - Vermivora cyanoptera
Bluethroat - Luscinia svecica
Boat-tailed Grackle - Quiscalus major
Bobolink - Dolichonyx oryzivorus
Bohemian Waxwing - Bombycilla garrulus
Bonaparte's Gull - Chroicocephalus philadelphia
Boreal Chickadee - Poecile hudsonicus
Boreal Owl - Aegolius funereus
Botteri's Sparrow - Peucaea botterii
Brambling - Fringilla montifringilla
Brandt's Cormorant - Phalacrocorax penicillatus
Brant - Branta bernicla
Brewer's Blackbird - Euphagus cyanocephalus
Brewer's Sparrow - Spizella breweri
Bridled Tern - Onychoprion anaethetus
Bridled Titmouse - Baeolophus wollweberi
Bristle-thighed Curlew - Numenius tahitiensis
Broad-billed Hummingbird - Cynanthus latirostris
Broad-billed Sandpiper - Calidris falcinellus
Broad-tailed Hummingbird - Selasphorus platycercus
Broad-winged Hawk - Buteo platypterus
Bronzed Cowbird - Molothrus aeneus
Brown Booby - Sula leucogaster
Brown Creeper - Certhia americana
Brown Jay - Psilorhinus morio
Brown Noddy - Anous stolidus
Brown Pelican - Pelecanus occidentalis
Brown Shrike - Lanius cristatus
Brown Thrasher - Toxostoma rufum
Brown-capped Rosy-Finch - Leucosticte australis
Brown-chested Martin - Progne tapera
Brown-crested Flycatcher - Myiarchus tyrannulus
Brown-headed Cowbird - Molothrus ater
Brown-headed Nuthatch - Sitta pusilla
Budgerigar - Melopsittacus undulatus
Buff-bellied Hummingbird - Amazilia yucatanensis
Buff-breasted Flycatcher - Empidonax fulvifrons
Buff-breasted Sandpiper - Calidris subruficollis
Buff-collared Nightjar - Antrostomus ridgwayi
Bufflehead - Bucephala albeola
Buller's Shearwater - Ardenna bulleri
Bullock's Oriole - Icterus bullockii
Bumblebee Hummingbird - Atthis heloisa
Burrowing Owl - Athene cunicularia
Bushtit - Psaltriparus minimus
Cactus Wren - Campylorhynchus brunneicapillus
California Condor - Gymnogyps californianus
California Gnatcatcher - Polioptila californica
California Gull - Larus californicus
California Scrub-jay - Aphelocoma californica
California Quail - Callipepla californica
California Thrasher - Toxostoma redivivum
California Towhee - Melozone crissalis
Calliope Hummingbird - Selasphorus calliope
Canada Goose - Branta canadensis
Canada Warbler - Cardellina canadensis
Canvasback - Aythya valisineria
Canyon Towhee - Melozone fusca
Canyon Wren - Catherpes mexicanus
Cape May Warbler - Setophaga tigrina
Caribbean Elaenia - Elaenia martinica
Caribbean Flamingo - Phoenicopterus ruber
Carolina Chickadee - Poecile carolinensis
Carolina Parakeet - Conuropsis carolinensis (extinct)
Carolina Wren - Thryothorus ludovicianus
Caspian Tern - Hydroprogne caspia
Cassin's Auklet - Ptychoramphus aleuticus
Cassin's Finch - Haemorhous cassinii
Cassin's Kingbird - Tyrannus vociferans
Cassin's Sparrow - Peucaea cassinii
Cassin's Vireo - Vireo cassinii
Cattle Egret - Bubulcus ibis
Cave Swallow - Petrochelidon fulva
Cedar Waxwing - Bombycilla cedrorum
Cerulean Warbler - Setophaga cerulea
Chestnut-backed Chickadee - Poecile rufescens
Chestnut-collared Longspur - Calcarius ornatus
Chestnut-sided Warbler - Setophaga pensylvanica
Chihuahuan Raven - Corvus cryptoleucus
Chimney Swift - Chaetura pelagica
Chinese Egret - Egretta eulophotes
Chipping Sparrow - Spizella passerina
Chuck-will's-widow - Antrostomus carolinensis
Chukar - Alectoris chukar
Cinnamon Hummingbird - Amazilia rutila
Cinnamon Teal - Spatula cyanoptera
Citrine Wagtail - Motacilla citreola
Clapper Rail - Rallus crepitans
Clark's Grebe - Aechmophorus clarkii
Clark's Nutcracker - Nucifraga columbiana
Clay-colored Robin - Turdus grayi
Clay-colored Sparrow - Spizella pallida
Cliff Swallow - Petrochelidon pyrrhonota
Colima Warbler - Leiothlypis crissalis
Collared Forest-Falcon - Micrastur semitorquatus
Collared Plover - Charadrius collaris
Common Black-Hawk - Buteogallus anthracinus
Common Chaffinch - Fringilla coelebs
Common Crane - Grus grus
Common Cuckoo - Cuculus canorus
Common Eider - Somateria mollissima
Common Gallinule - Gallinula galeata
Common Goldeneye - Bucephala clangula
Common Grackle - Quiscalus quiscula
Common Greenshank - Tringa nebularia
Common Ground-Dove - Columbina passerina
Common House-Martin - Delichon urbicum
Common Loon - Gavia immer
Common Merganser - Mergus merganser
Common Murre - Uria aalge
Common Nighthawk - Chordeiles minor
Common Pauraque - Nyctidromus albicollis
Common Pochard - Aythya ferina
Common Poorwill - Phalaenoptilus nuttallii
Common Raven - Corvus corax
Common Redpoll - Acanthis flammea
Common Redshank - Tringa totanus
Common Ringed Plover - Charadrius hiaticula
Common Rosefinch - Carpodacus erythrinus
Common Sandpiper - Actitis hypoleucos
Common Snipe - Gallinago gallinago
Common Swift - Apus apus
Common Tern - Sterna hirundo
Common Yellowthroat - Geothlypis trichas
Connecticut Warbler - Oporornis agilis
Cook's Petrel - Pterodroma cookii
Cooper's Hawk - Accipiter cooperii
Cordilleran Flycatcher - Empidonax occidentalis
Corn Crake - Crex crex
Cory's Shearwater - Calonectris diomedea
Costa's Hummingbird - Calypte costae
Couch's Kingbird - Tyrannus couchii
Crane Hawk - Geranospiza caerulescens
Craveri's Murrelet - Synthliboramphus craveri
Crescent-chested Warbler - Oreothlypis superciliosa
Crested Auklet - Aethia cristatella
Crested Caracara - Caracara cheriway
Crested Myna - Acridotheres cristatellus
Crimson-collared Grosbeak - Rhodothraupis celaeno
Crissal Thrasher - Toxostoma crissale
Cuban Martin - Progne cryptoleuca
Curlew Sandpiper - Calidris ferruginea
Curve-billed Thrasher - Toxostoma curvirostre
Dark-eyed Junco - Junco hyemalis
Dickcissel - Spiza americana
Double-crested Cormorant - Phalacrocorax auritus
Double-striped Thick-knee - Burhinus bistriatus
Dovekie - Alle alle
Downy Woodpecker - Picoides pubescens
Dunlin - Calidris alpina
Dusky Flycatcher - Empidonax oberholseri
Dusky Grouse - Dendragapus obscurus
Dusky Thrush - Turdus eunomus
Dusky Warbler - Phylloscopus fuscatus
Dusky-capped Flycatcher - Myiarchus tuberculifer
Eared Grebe - Podiceps nigricollis
Eared Trogon - Euptilotis neoxenus
Eastern Bluebird - Sialia sialis
Eastern Kingbird - Tyrannus tyrannus
Eastern Meadowlark - Sturnella magna
Eastern Phoebe - Sayornis phoebe
Eastern Screech-Owl - Megascops asio
Eastern Towhee - Pipilo erythrophthalmus
Eastern Wood-Pewee - Contopus virens
Elegant Tern - Thalasseus elegans
Elegant Trogon - Trogon elegans
Elf Owl - Micrathene whitneyi
Emperor Goose - Anser canagicus
Eurasian Blackbird - Turdus merula
Eurasian Bullfinch - Pyrrhula pyrrhula
Eurasian Collared-Dove - Streptopelia decaocto
Eurasian Coot - Fulica atra
Eurasian Curlew - Numenius arquata
Eurasian Dotterel - Charadrius morinellus
Eurasian Hobby - Falco subbuteo
Eurasian Jackdaw - Corvus monedula
Eurasian Kestrel - Falco tinnunculus
Eurasian Oystercatcher - Haematopus ostralegus
Eurasian Siskin - Spinus spinus
Eurasian Tree Sparrow - Passer montanus
Eurasian Wigeon - Mareca penelope
Eurasian Woodcock - Scolopax rusticola
Eurasian Wryneck - Jynx torquilla
European Golden-Plover - Pluvialis apricaria
European Shag - Phalacrocorax aristotelis
European Starling - Sturnus vulgaris
European Storm-Petrel - Hydrobates pelagicus
European Turtle-Dove - Streptopelia turtur
Evening Grosbeak - Coccothraustes vespertinus
Eyebrowed Thrush - Turdus obscurus
Falcated Duck - Mareca falcata
Fan-tailed Warbler - Basileuterus lachrymosus
Far Eastern Curlew - Numenius madagascariensis
Ferruginous Hawk - Buteo regalis
Ferruginous Pygmy-Owl - Glaucidium brasilianum
Field Sparrow - Spizella pusilla
Fieldfare - Turdus pilaris
Fish Crow - Corvus ossifragus
Five-striped Sparrow - Amphispiza quinquestriata
Flame-colored Tanager - Piranga bidentata
Flammulated Owl - Psiloscops flammeolus
Flesh-footed Shearwater - Ardenna carneipes
Florida Scrub-Jay - Aphelocoma coerulescens
Fork-tailed Flycatcher - Tyrannus savana
Fork-tailed Storm-Petrel - Oceanodroma furcata
Fork-tailed Swift - Apus pacificus
Forster's Tern - Sterna forsteri
Fox Sparrow - Passerella iliaca
Franklin's Gull - Leucophaeus pipixcan
Fulvous Whistling-Duck - Dendrocygna bicolor
Gadwall - Mareca strepera
Gambel's Quail - Callipepla gambelii
Garganey - Spatula querquedula
Gila Woodpecker - Melanerpes uropygialis
Gilded Flicker - Colaptes chrysoides
Glaucous Gull - Larus hyperboreus
Glaucous-winged Gull - Larus glaucescens
Glossy Ibis - Plegadis falcinellus
Golden Eagle - Aquila chrysaetos
Golden-cheeked Warbler - Setophaga chrysoparia
Golden-crowned Kinglet - Regulus satrapa
Golden-crowned Sparrow - Zonotrichia atricapilla
Golden-crowned Warbler - Basileuterus culicivorus
Golden-fronted Woodpecker - Melanerpes aurifrons
Golden-winged Warbler - Vermivora chrysoptera
Gould's Wild Turkey - Meleagris gallopavo mexicana
Grace's Warbler - Setophaga graciae
Grasshopper Sparrow - Ammodramus savannarum
Gray Bunting - Emberiza variabilis
Gray Catbird - Dumetella carolinensis
Gray Flycatcher - Empidonax wrightii
Gray Hawk - Buteo plagiatus
Gray Jay - Perisoreus canadensis
Gray Kingbird - Tyrannus dominicensis
Gray Partridge - Perdix perdix
Gray Silky-flycatcher - Ptiliogonys cinereus
Gray Vireo - Vireo vicinior
Gray Wagtail - Motacilla cinerea
Gray-breasted Martin - Progne chalybea
Gray-cheeked Thrush - Catharus minimus
Gray-crowned Rosy-Finch - Leucosticte tephrocotis
Gray-crowned Yellowthroat - Geothlypis poliocephala
Gray-headed Chickadee - Poecile cinctus
Gray-spotted Flycatcher - Muscicapa griseisticta
Gray-tailed Tattler - Tringa brevipes
Great Black-backed Gull - Larus marinus
Great Blue Heron - Ardea herodias
Great Cormorant - Phalacrocorax carbo
Great Crested Flycatcher - Myiarchus crinitus
Great Egret - Ardea alba
Great Frigatebird - Fregata minor
Great Gray Owl - Strix nebulosa
Great Horned Owl - Bubo virginianus
Great Kiskadee - Pitangus sulphuratus
Great Knot - Calidris tenuirostris
Great Skua - Stercorarius skua
Great Spotted Woodpecker - Dendrocopos major
Great-tailed Grackle - Quiscalus mexicanus
Greater Flamingo - Phoenicopterus roseus
Greater Pewee - Contopus pertinax
Greater Prairie-Chicken - Tympanuchus cupido
Greater Roadrunner - Geococcyx californianus
Greater Scaup - Aythya marila
Greater Shearwater - Ardenna gravis
Greater White-fronted Goose - Anser albifrons
Greater Yellowlegs - Tringa melanoleuca
Green Heron - Butorides virescens
Green Jay - Cyanocorax yncas
Green Kingfisher - Chloroceryle americana
Green Sandpiper - Tringa ochropus
Green Violet-ear - Colibri thalassinus
Green-breasted Mango - Anthracothorax prevostii
Green-tailed Towhee - Pipilo chlorurus
Green-winged Teal - Anas crecca
Greenish Elaenia - Elaenia flavogaster
Greylag Goose - Anser anser
Groove-billed Ani - Crotophaga sulcirostris
Gull-billed Tern - Gelochelidon nilotica
Gyrfalcon - Falco rusticolus
Hairy Woodpecker - Picoides villosus
Hammond's Flycatcher - Empidonax hammondii
Harlequin Duck - Histrionicus histrionicus
Harris's Hawk - Parabuteo unicinctus
Harris's Sparrow - Zonotrichia querula
Hawfinch - Coccothraustes coccothraustes
Heermann's Gull - Larus heermanni
Henslow's Sparrow - Ammodramus henslowii
Hepatic Tanager - Piranga flava
Herald Petrel - Pterodroma arminjoniana
Hermit Thrush - Catharus guttatus
Hermit Warbler - Setophaga occidentalis
Herring Gull - Larus argentatus
Himalayan Snowcock - Tetraogallus himalayensis
Hispaniolan Woodpecker - Melanerpes striatus
Hoary Redpoll - Acanthis hornemanni
Hooded Merganser - Lophodytes cucullatus
Hooded Oriole - Icterus cucullatus
Hooded Warbler - Setophaga citrina
Hook-billed Kite - Chondrohierax uncinatus
Hoopoe - Upupa epops
Horned Grebe - Podiceps auritus
Horned Lark - Eremophila alpestris
Horned Puffin - Fratercula corniculata
House Finch - Haemorhous mexicanus
House Sparrow - Passer domesticus
House Wren - Troglodytes aedon
Hudsonian Godwit - Limosa haemastica
Hutton's Vireo - Vireo huttoni
Iceland Gull - Larus glaucoides
Inca Dove - Columbina inca
Indigo Bunting - Passerina cyanea
Island Scrub-Jay - Aphelocoma insularis
Ivory Gull - Pagophila eburnea
Ivory-billed Woodpecker - Campephilus principalis (critically endangered/possibly extinct)
Jabiru - Jabiru mycteria
Jack Snipe - Lymnocryptes minimus
Jungle Nightjar - Caprimulgus indicus
Juniper Titmouse - Baeolophus ridgwayi
Kentucky Warbler - Geothlypis formosa
Key West Quail-Dove - Geotrygon chrysia
Killdeer - Charadrius vociferus
King Eider - Somateria spectabilis
King Rail - Rallus elegans
Kirtland's Warbler - Setophaga kirtlandii
Kittlitz's Murrelet - Brachyramphus brevirostris
La Sagra's Flycatcher - Myiarchus sagrae
Labrador Duck - Camptorhynchus labradorius (extinct)
Ladder-backed Woodpecker - Picoides scalaris
Lanceolated Warbler - Locustella lanceolata
Lapland Longspur - Calcarius lapponicus
Large-billed Tern - Phaetusa simplex
Lark Bunting - Calamospiza melanocorys
Lark Sparrow - Chondestes grammacus
Laughing Gull - Leucophaeus atricilla
Lawrence's Goldfinch - Spinus lawrencei
Laysan Albatross - Phoebastria immutabilis
Lazuli Bunting - Passerina amoena
Le Conte's Sparrow - Ammospiza leconteii
Le Conte's Thrasher - Toxostoma lecontei
Leach's Storm-Petrel - Oceanodroma leucorhoa
Least Auklet - Aethia pusilla
Least Bittern - Ixobrychus exilis
Least Flycatcher - Empidonax minimus
Least Grebe - Tachybaptus dominicus
Least Sandpiper - Calidris minutilla
Least Storm-Petrel - Oceanodroma microsoma
Least Tern - Sternula antillarum
Lesser Black-backed Gull - Larus fuscus
Lesser Frigatebird - Fregata ariel
Lesser Goldfinch - Spinus psaltria
Lesser Nighthawk - Chordeiles acutipennis
Lesser Prairie-Chicken - Tympanuchus pallidicinctus
Lesser Scaup - Aythya affinis
Lesser White-fronted Goose - Anser erythropus
Lesser Yellowlegs - Tringa flavipes
Lewis's Woodpecker - Melanerpes lewis
Limpkin - Aramus guarauna
Lincoln's Sparrow - Melospiza lincolnii
Little Blue Heron - Egretta caerulea
Little Bunting - Emberiza pusilla
Little Curlew - Numenius minutus
Little Egret - Egretta garzetta
Little Gull - Hydrocoloeus minutus
Little Ringed Plover - Charadrius dubius
Little Shearwater - Puffinus assimilis
Little Stint - Calidris minuta
Loggerhead Kingbird - Tyrannus caudifasciatus
Loggerhead Shrike - Lanius ludovicianus
Long-billed Curlew - Numenius americanus
Long-billed Dowitcher - Limnodromus scolopaceus
Long-billed Murrelet - Brachyramphus perdix
Long-billed Thrasher - Toxostoma longirostre
Long-eared Owl - Asio otus
Long-tailed Jaeger - Stercorarius longicaudus
Long-toed Stint - Calidris subminuta
Louisiana Waterthrush - Parkesia motacilla
Lucifer Hummingbird - Calothorax lucifer
Lucy's Warbler - Oreothlypis luciae
MacGillivray's Warbler - Geothlypis tolmiei
Magnificent Frigatebird - Fregata magnificens
Magnificent Hummingbird - Eugenes fulgens
Magnolia Warbler - Setophaga magnolia
Mallard - Anas platyrhynchos
Mangrove Cuckoo - Coccyzus minor
Manx Shearwater - Puffinus puffinus
Marbled Godwit - Limosa fedoa
Marbled Murrelet - Brachyramphus marmoratus
Marsh Sandpiper - Tringa stagnatilis
Marsh Wren - Cistothorus palustris
Masked Booby - Sula dactylatra
Masked Duck - Nomonyx dominicus
Masked Tityra - Tityra semifasciata
McCown's Longspur - Rhynchophanes mccownii
McKay's Bunting - Plectrophenax hyperboreus
Merlin - Falco columbarius
Mew Gull - Larus canus
Mexican Chickadee - Poecile sclateri
Mexican Duck - Anas diazi
Mexican Jay - Aphelocoma wollweberi
Middendorff's Grasshopper-Warbler - Locustella ochotensis
Mississippi Kite - Ictinia mississippiensis
Mongolian Plover - Charadrius mongolus
Monk Parakeet - Myiopsitta monachus
Montezuma Quail - Cyrtonyx montezumae
Mottled Duck - Anas fulvigula
Mottled Owl - Ciccaba virgata
Mottled Petrel - Pterodroma inexpectata
Mountain Bluebird - Sialia currucoides
Mountain Chickadee - Poecile gambeli
Mountain Plover - Charadrius montanus
Mountain Quail - Oreortyx pictus
Mourning Dove - Zenaida macroura
Mourning Warbler - Geothlypis philadelphia
Mugimaki Flycatcher - Ficedula mugimaki
Murphy's Petrel - Pterodroma ultima
Muscovy Duck - Cairina moschata
Mute Swan - Cygnus olor
Narcissus Flycatcher - Ficedula narcissina
Nashville Warbler - Oreothlypis ruficapilla
Nelson's Sharp-tailed Sparrow - Ammodramus nelsoni
Neotropic Cormorant - Phalacrocorax brasilianus
Northern Beardless-Tyrannulet - Camptostoma imberbe
Northern Bobwhite - Colinus virginianus
Northern Cardinal - Cardinalis cardinalis
Northern Flicker - Colaptes auratus
Northern Fulmar - Fulmarus glacialis
Northern Gannet - Morus bassanus
Northern Goshawk - Accipiter gentilis
Northern Harrier - Circus hudsonius
Northern Hawk Owl - Surnia ulula
Northern Jacana - Jacana spinosa
Northern Lapwing - Vanellus vanellus
Northern Mockingbird - Mimus polyglottos
Northern Parula - Setophaga americana
Northern Pintail - Anas acuta
Northern Pygmy-Owl - Glaucidium gnoma
Northern Rough-winged Swallow - Stelgidopteryx serripennis
Northern Saw-whet Owl - Aegolius acadicus
Northern Shoveler - Spatula clypeata
Northern Shrike - Lanius excubitor
Northern Waterthrush - Parkesia noveboracensis
Northern Wheatear - Oenanthe oenanthe
Northwestern Crow - Corvus caurinus
Nuttall's Woodpecker - Dryobates nuttallii
Nutting's Flycatcher - Myiarchus nuttingi
Oak Titmouse - Baeolophus inornatus
Oldsquaw (Long-tailed Duck) - Clangula hyemalis
Olive Sparrow - Arremonops rufivirgatus
Olive Warbler - Peucedramus taeniatus
Olive-backed Pipit - Anthus hodgsoni
Olive-sided Flycatcher - Contopus cooperi
Orange-crowned Warbler - Leiothlypis celata
Orchard Oriole - Icterus spurius
Oriental Cuckoo - Cuculus optatus
Oriental Greenfinch - Chloris sinica
Oriental Pratincole - Glareola maldivarum
Oriental Scops-Owl - Otus sunia
Oriental Turtle-Dove - Streptopelia orientalis
Osprey - Pandion haliaetus
Ovenbird - Seiurus aurocapilla
Pacific Golden-Plover - Pluvialis fulva
Pacific Loon - Gavia pacifica
Pacific Wren - Troglodytes pacificus
Pacific-slope Flycatcher - Empidonax difficilis
Paint-billed Crake - Neocrex erythrops
Painted Bunting - Passerina ciris
Painted Redstart - Myioborus pictus
Pallas's Bunting - Emberiza pallasi
Palm Warbler - Setophaga palmarum
Parakeet Auklet - Aethia psittacula
Parasitic Jaeger - Stercorarius parasiticus
Passenger Pigeon - Ectopistes migratorius (extinct)
Pechora Pipit - Anthus gustavi
Pectoral Sandpiper - Calidris melanotos
Pelagic Cormorant - Phalacrocorax pelagicus
Peregrine Falcon - Falco peregrinus
Phainopepla - Phainopepla nitens
Philadelphia Vireo - Vireo philadelphicus
Pied-billed Grebe - Podilymbus podiceps
Pigeon Guillemot - Cepphus columba
Pileated Woodpecker - Dryocopus pileatus
Pin-tailed Snipe - Gallinago stenura
Pine Bunting - Emberiza leucocephalos
Pine Grosbeak - Pinicola enucleator
Pine Siskin - Spinus pinus
Pine Warbler - Setophaga pinus
Pink-footed Goose - Anser brachyrhynchus
Pink-footed Shearwater - Ardenna creatopus
Pinyon Jay - Gymnorhinus cyanocephalus
Piping Plover - Charadrius melodus
Plain Chachalaca - Ortalis vetula
Plain-capped Starthroat - Heliomaster constantii
Plumbeous Vireo - Vireo plumbeus
Pomarine Jaeger - Stercorarius pomarinus
Prairie Falcon - Falco mexicanus
Prairie Warbler - Setophaga discolor
Prothonotary Warbler - Protonotaria citrea
Purple Finch - Haemorhous purpureus
Purple Gallinule - Porphyrio martinicus
Purple Martin - Progne subis
Purple Sandpiper - Calidris maritima
Pygmy Nuthatch - Sitta pygmaea
Pyrrhuloxia - Cardinalis sinuatus
Razorbill - Alca torda
Red Crossbill - Loxia curvirostra
Red Knot - Calidris canutus
Red Phalarope - Phalaropus fulicarius
Red-bellied Woodpecker - Melanerpes carolinus
Red-billed Pigeon - Patagioenas flavirostris
Red-billed Tropicbird - Phaethon aethereus
Red-breasted Flycatcher - Ficedula parva
Red-breasted Merganser - Mergus serrator
Red-breasted Nuthatch - Sitta canadensis
Red-breasted Sapsucker - Sphyrapicus ruber
Red-capped Parrot - Purpureicephalus spurius
Red-cockaded Woodpecker - Dryobates borealis
Red-crowned Parrot - Amazona viridigenalis
Red-eyed Vireo - Vireo olivaceus
Red-faced Cormorant - Phalacrocorax urile
Red-faced Warbler - Cardellina rubrifrons
Red-flanked Bluetail - Tarsiger cyanurus
Red-footed Booby - Sula sula
Red-headed Woodpecker - Melanerpes erythrocephalus
Red-legged Kittiwake - Rissa brevirostris
Red-naped Sapsucker - Sphyrapicus nuchalis
Red-necked Grebe - Podiceps grisegena
Red-necked Phalarope - Phalaropus lobatus
Red-necked Stint - Calidris ruficollis
Red-shouldered Hawk - Buteo lineatus
Red-tailed Hawk - Buteo jamaicensis
Red-tailed Tropicbird - Phaethon rubricauda
Red-throated Loon - Gavia stellata
Red-throated Pipit - Anthus cervinus
Red-whiskered Bulbul - Pycnonotus jocosus
Red-winged Blackbird - Agelaius phoeniceus
Reddish Egret - Egretta rufescens
Redhead - Aythya americana
Redwing - Turdus iliacus
Reed Bunting - Emberiza schoeniclus
Rhinoceros Auklet - Cerorhinca monocerata
Ring-billed Gull - Larus delawarensis
Ring-necked Duck - Aythya collaris
Ring-necked Pheasant - Phasianus colchicus
Ringed Kingfisher - Megaceryle torquata
Rivoli's Hummingbird - Eugenes fulgens
Roadside Hawk - Rupornis magnirostris
Rock Dove (Feral Pigeon) - Columba livia
Rock Ptarmigan - Lagopus muta
Rock Sandpiper - Calidris ptilocnemis
Rock Wren - Salpinctes obsoletus
Rose-breasted Grosbeak - Pheucticus ludovicianus
Rose-throated Becard - Pachyramphus aglaiae
Roseate Spoonbill - Platalea ajaja
Roseate Tern - Sterna dougallii
Ross's Goose - Anser rossii
Ross's Gull - Rhodostethia rosea
Rough-legged Hawk - Buteo lagopus
Royal Tern - Thalasseus maximus
Ruby-crowned Kinglet - Regulus calendula
Ruby-throated Hummingbird - Archilochus colubris
Ruddy Duck - Oxyura jamaicensis
Ruddy Ground-Dove - Columbina talpacoti
Ruddy Quail-Dove - Geotrygon montana
Ruddy Turnstone - Arenaria interpres
Ruff - Calidris pugnax
Ruffed Grouse - Bonasa umbellus
Rufous Hummingbird - Selasphorus rufus
Rufous-backed Robin - Turdus rufopalliatus
Rufous-capped Warbler - Basileuterus rufifrons
Rufous-crowned Sparrow - Aimophila ruficeps
Rufous-winged Sparrow - Peucaea carpalis
Rustic Bunting - Emberiza rustica
Rusty Blackbird - Euphagus carolinus
Sabine's Gull - Xema sabini
Sage Grouse - Centrocercus urophasianus
Sage Sparrow - Artemisiospiza belli
Sage Thrasher - Oreoscoptes montanus
Saltmarsh Sharp-tailed Sparrow - Ammospiza caudacuta
Sanderling - Calidris alba
Sandhill Crane - Antigone canadensis
Sandwich Tern - Thalasseus sandvicensis
Savannah Sparrow - Passerculus sandwichensis
Say's Phoebe - Sayornis saya
Scaled Quail - Callipepla squamata
Scaly-breasted Munia - Lonchura punctulata
Scaly-naped Pigeon - Patagioenas squamosa
Scarlet Ibis - Eudocimus ruber
Scarlet Tanager - Piranga olivacea
Scissor-tailed Flycatcher - Tyrannus forficatus
Scott's Oriole - Icterus parisorum
Seaside Sparrow - Ammospiza maritima
Sedge Wren - Cistothorus platensis
Semipalmated Plover - Charadrius semipalmatus
Semipalmated Sandpiper - Calidris pusilla
Sharp-shinned Hawk - Accipiter striatus
Sharp-tailed Grouse - Tympanuchus phasianellus
Sharp-tailed Sandpiper - Calidris acuminata
Shiny Cowbird - Molothrus bonariensis
Short-billed Dowitcher - Limnodromus griseus
Short-eared Owl - Asio flammeus
Short-tailed Albatross - Phoebastria albatrus
Short-tailed Hawk - Buteo brachyurus
Short-tailed Shearwater - Ardenna tenuirostris
Shy Albatross - Thalassarche cauta
Siberian Accentor - Prunella montanella
Siberian Blue Robin - Larvivora cyane
Siberian Flycatcher - Ficedula albicilla
Siberian Rubythroat - Calliope calliope
Sky Lark - Alauda arvensis
Slate-throated Redstart - Myioborus miniatus
Slaty-backed Gull - Larus schistisagus
Slender-billed Curlew - Numenius tenuirostris (critically endangered/possibly extinct)
Smew - Mergellus albellus
Smith's Longspur - Calcarius pictus
Smooth-billed Ani - Crotophaga ani
Snail Kite - Rostrhamus sociabilis
Snow Bunting - Plectrophenax nivalis
Snow Goose - Anser caerulescens
Snowy Egret - Egretta thula
Snowy Owl - Bubo scandiacus
Snowy Plover - Charadrius nivosus
Solitary Sandpiper - Tringa solitaria
Song Sparrow - Melospiza melodia
Sooty Grouse - Dendragapus fuliginosus
Sooty Shearwater - Ardenna grisea
Sooty Tern - Onychoprion fuscatus
Sora - Porzana carolina
South Polar Skua - Stercorarius maccormicki
Southern Martin - Progne elegans
Spectacled Eider - Somateria fischeri
Spoonbill Sandpiper - Calidris pygmaea
Spot-billed Duck - Anas poecilorhyncha
Spot-breasted Oriole - Icterus pectoralis
Spotted Dove - Streptopelia chinensis
Spotted Owl - Strix occidentalis
Spotted Rail - Pardirallus maculatus
Spotted Redshank - Tringa erythropus
Spotted Sandpiper - Actitis macularius
Spotted Towhee - Pipilo maculatus
Sprague's Pipit - Anthus spragueii
Spruce Grouse - Falcipennis canadensis
Stejneger's Petrel - Pterodroma longirostris
Steller's Eider - Polysticta stelleri
Steller's Jay - Cyanocitta stelleri
Steller's Sea-Eagle - Haliaeetus pelagicus
Stilt Sandpiper - Calidris himantopus
Stonechat - Saxicola torquatus
Streak-backed Oriole - Icterus pustulatus
Streaked Shearwater - Calonectris leucomelas
Strickland's Woodpecker - Picoides stricklandi
Stripe-headed Tanager - Spindalis zena
Sulphur-bellied Flycatcher - Myiodynastes luteiventris
Summer Tanager - Piranga rubra
Surf Scoter - Melanitta perspicillata
Surfbird - Calidris virgata
Swainson's Hawk - Buteo swainsoni
Swainson's Thrush - Catharus ustulatus
Swainson's Warbler - Limnothlypis swainsonii
Swallow-tailed Kite - Elanoides forficatus
Swamp Sparrow - Melospiza georgiana
Tamaulipas Crow - Corvus imparatus
Tawny-shouldered Blackbird - Agelaius humeralis
Temminck's Stint - Calidris temminckii
Tennessee Warbler - Leiothlypis peregrina
Terek Sandpiper - Xenus cinereus
Thayer's Gull - Larus thayeri
Thick-billed Kingbird - Tyrannus crassirostris
Thick-billed Murre - Uria lomvia
Thick-billed Parrot - Rhynchopsitta pachyrhyncha
Thick-billed Vireo - Vireo crassirostris
Three-toed Woodpecker - Picoides tridactylus
Townsend's Solitaire - Myadestes townsendi
Townsend's Warbler - Setophaga townsendi
Tree Pipit - Anthus trivialis
Tree Swallow - Tachycineta bicolor
Tricolored Blackbird - Agelaius tricolor
Tricolored Heron - Egretta tricolor
Tropical Kingbird - Tyrannus melancholicus
Tropical Parula - Setophaga pitiayumi
Trumpeter Swan - Cygnus buccinator
Tufted Duck - Aythya fuligula
Tufted Flycatcher - Mitrephanes phaeocercus
Tufted Puffin - Fratercula cirrhata
Tufted Titmouse - Baeolophus bicolor
Tundra Swan - Cygnus columbianus
Turkey Vulture - Cathartes aura
Upland Sandpiper - Bartramia longicauda
Varied Bunting - Passerina versicolor
Varied Thrush - Ixoreus naevius
Variegated Flycatcher - Empidonomus varius
Vaux's Swift - Chaetura vauxi
Veery - Catharus fuscescens
Verdin - Auriparus flaviceps
Vermilion Flycatcher - Pyrocephalus rubinus
Vesper Sparrow - Pooecetes gramineus
Violet-crowned Hummingbird - Amazilia violiceps
Violet-green Swallow - Tachycineta thalassina
Virginia Rail - Rallus limicola
Virginia's Warbler - Leiothlypis virginiae
Wandering Albatross - Diomedea exulans
Wandering Tattler - Tringa incana
Warbling Vireo - Vireo gilvus
Wedge-rumped Storm-Petrel - Oceanodroma tethys
Wedge-tailed Shearwater - Ardenna pacifica
Western Bluebird - Sialia mexicana
Western Grebe - Aechmophorus occidentalis
Western Gull - Larus occidentalis
Western Kingbird - Tyrannus verticalis
Western Meadowlark - Sturnella neglecta
Western Reef-Heron - Egretta gularis
Western Sandpiper - Calidris mauri
Western Screech-Owl - Megascops kennicottii
Western Scrub-Jay - Aphelocoma californica
Western Tanager - Piranga ludoviciana
Western Wood-Pewee - Contopus sordidulus
Whimbrel - Numenius phaeopus
Whip-poor-will - Antrostomus vociferus
Whiskered Auklet - Aethia pygmaea
Whiskered Screech-Owl - Megascops trichopsis
Whiskered Tern - Chlidonias hybrida
White Ibis - Eudocimus albus
White Wagtail - Motacilla alba
White-breasted Nuthatch - Sitta carolinensis
White-cheeked Pintail - Anas bahamensis
White-chinned Petrel - Procellaria aequinoctialis
White-collared Seedeater - Sporophila torqueola
White-collared Swift - Streptoprocne zonaris
White-crowned Pigeon - Patagioenas leucocephala
White-crowned Sparrow - Zonotrichia leucophrys
White-eared Hummingbird - Hylocharis leucotis
White-eyed Vireo - Vireo griseus
White-faced Ibis - Plegadis chihi
White-faced Storm-Petrel - Pelagodroma marina
White-headed Woodpecker - Dryobates albolarvatus
White-rumped Sandpiper - Calidris fuscicollis
White-tailed Eagle - Haliaeetus albicilla
White-tailed Hawk - Geranoaetus albicaudatus
White-tailed Kite - Elanus leucurus
White-tailed Ptarmigan - Lagopus leucura
White-tailed Tropicbird - Phaethon lepturus
White-throated Needletail - Hirundapus caudacutus
White-throated Robin - Irania gutturalis
White-throated Sparrow - Zonotrichia albicollis
White-throated Swift - Aeronautes saxatalis
White-tipped Dove - Leptotila verreauxi
White-winged Crossbill - Loxia leucoptera
White-winged Dove - Zenaida asiatica
White-winged Parakeet - Brotogeris versicolurus
White-winged Scoter - Melanitta deglandi
White-winged Tern - Chlidonias leucopterus
Whooper Swan - Cygnus cygnus
Whooping Crane - Grus americana
Wild Turkey - Meleagris gallopavo
Willet - Tringa semipalmata
Williamson's Sapsucker - Sphyrapicus thyroideus
Willow Flycatcher - Empidonax traillii
Willow Ptarmigan - Lagopus lagopus
Wilson's Phalarope - Phalaropus tricolor
Wilson's Plover - Charadrius wilsonia
Wilson's Snipe - Gallinago delicata
Wilson's Storm-Petrel - Oceanites oceanicus
Wilson's Warbler - Cardellina pusilla
Winter Wren - Troglodytes hiemalis
Wood Duck - Aix sponsa
Wood Sandpiper - Tringa glareola
Wood Stork - Mycteria americana
Wood Thrush - Hylocichla mustelina
Wood Warbler - Phylloscopus sibilatrix
Woodhouse's Scrub-Jay - Aphelocoma woodhouseii
Worm-eating Warbler - Helmitheros vermivorum
Worthen's Sparrow - Spizella wortheni
Wrentit - Chamaea fasciata
Xantus's Hummingbird - Basilinna xantusii
Xantus's Murrelet - Synthliboramphus hypoleucus
Yellow Bittern - Ixobrychus sinensis
Yellow Grosbeak - Pheucticus chrysopeplus
Yellow Rail - Coturnicops noveboracensis
Yellow Wagtail - Motacilla flava
Yellow Warbler - Setophaga petechia
Yellow-bellied Flycatcher - Empidonax flaviventris
Yellow-bellied Sapsucker - Sphyrapicus varius
Yellow-billed Cuckoo - Coccyzus americanus
Yellow-billed Loon - Gavia adamsii
Yellow-billed Magpie - Pica nuttalli
Yellow-breasted Bunting - Emberiza aureola
Yellow-breasted Chat - Icteria virens
Yellow-crowned Night-Heron - Nyctanassa violacea
Yellow-eyed Junco - Junco phaeonotus
Yellow-faced Grassquit - Tiaris olivaceus
Yellow-footed Gull - Larus livens
Yellow-green Vireo - Vireo flavoviridis
Yellow-headed Blackbird - Xanthocephalus xanthocephalus
Yellow-legged Gull - Larus michahellis
Yellow-nosed Albatross - Thalassarche chlororhynchos
Yellow-rumped Warbler - Setophaga coronata
Yellow-throated Vireo - Vireo flavifrons
Yellow-throated Warbler - Setophaga dominica
Yucatan Vireo - Vireo magister
Zenaida Dove - Zenaida aurita
Zone-tailed Hawk - Buteo albonotatus
Apapane - Himatione sanguinea
Common Myna - Acridotheres tristis
Common Waxbill - Estrilda astrild
Erckel's Francolin - Pternistis erckelii
Saffron Finch - Sicalis flaveola
Yellow-billed Cardinal - Paroaria capitata
Zebra Dove - Geopelia striata
Yellow-fronted Canary - Crithagra mozambica




